1111111111111111111111111111
10000C0000000C00N00000C00001
110011100000000000100000C001
1E00000000000000001000000001
11100000000000000010C0000001
1C00000000000000000000000P01
1111111111110111111111111111
100C000000000000000111000001
100000000C0000N0000000000001
1111111111111111111111111111
